1111111111111111
100E0000000000P1
1000000100000001
1011110101111101
1010010101000101
1011110001111101
1000001111000001
1111100000011111
1000001111000001
1111101001011111
10000010010001C1
1011101111011101
1P10100000000001
1111111111111111